NO ./textures/north_wall.xpm
SO ./textures/south_wall.xpm
WE ./textures/west_wall.xpm
EA ./textures/east_wall.xpm

F 181,101,29
C 50,100,150

1111111111111111111111111
1000000000000000000000001
1011111111111011111111101
1000000000011000000000001
1011111111011111111111101
1000000000000000000000001
1011111111111111111111101
    1000000000000000000000001
1011111111011111111111101
1000000000010000000000001
1011111111011    1111111111011111
    1000000000000E00000000001
10111111111111111111111111111
1000000000000000000000001
1011111111111011111111101
    1000000000011000000000001
1011111111011111111111101
1000000000000000000000001
1011111111111111111111101
    1000000000000000000000000001
1011111111011111111111101
1000000000010000000000001
10111111110101111111110111111
10000000000000000000000000001
111110001111100001111001111111
    11111   111111  111