NO ./textures/north_wall.xpm
SO ./textures/south_wall.xpm
WE ./textures/west_wall.xpm
EA ./textures/east_wall.xpm

F 220,100,0
C 225,30,0

1111111111111111111111111
1000000000000000000000001
1011111111111011111111101
1000000000011000000000001
1011111111011111111111101
1000000000000000000000001
1011111111111111111111101
1000000000000000000000001
1011111111011111111111101
1000000000010000000000001
1011111111011111111111101
1000000000010N01000000001
1011111111111111111111101
1000000000000000000000001
1011111111111011111111101
1000000000011000000000001
1011111111011111111111101
1000000000000000000000001
1011111111111111111111101
1000000000000000000000001
1011111111011111111111101
1000000000010000000000001
1011111111010111111111101
1000000000000000000000001
1111111111111111111111111